B B B B B B B B B B B B B B B B B B B B B B B B V B B B B B B B B B B B B B B B B B B B B B B B B B V B B B B B B B B B B B B B B B B B B B B B B B B B B B B B B B B B V V B B B B B B B B B B B B B B 
B B B B B B B B B B B B B B B B B B B B B B B B V V B B B B B B B B B B B B B B B B B B B B B B B B V V B B B B B B B B B B B B B B B B B B B B B B B B B B B B B B B B B V V V B B B B B B B B B B B B 
B B B B B B B B B B B B B B B B B B B B B B B B V V V B B B B B B B B B B B B B B B B B B B B B B B B V V B B B B B B B B B B B B B B B B B B B B B B B B B B B B B B B B B B V V B B B B B B B B B B B 
B B B B B B B B B B B B B B B B B B B B B B B B V V V B B B B B B B B B B B B B B B B B B B B B B B B B V V B B B B B B B B B B B B B B B B B B B B B B B B B B B B B B B B B B V B B B B B B B B B B B 
B B B B B B B B B B B B B B B B B B B B B B B B B V V V B B B B B B B B B B B B B B B B B B B B B B B B B V V V B B B B B B B B B B B B B B B B B B B B B B B B B B B B B B B B V V B B B B B B B B B B 
B B B B B B B B B B B B B B B B B B B B B B B B B V B V V V B B B B B B B B B B B B B B B B B B B B B B B B B V V V B B B B B B B B B B B B B B B B B B B B B B B B B B B B B B B V B B B B B B B B B B 
B B B B B B B B B B B B B B B B B B B B B B B B B V V B B V B B B B B B B B B B B B B B B B B B B B B B B B B B B V V B B B B B B B B B B B B B B B B B B B B B B B B B B B B B B V B B B B B B B B B B 
B B B B B B B B B B B B B B B B B B B B B B B B B B V B B V B B B B B B B B B B B B B B B B B B B B B B B B B B B B V B B B B B B B B B B B B B B B B B B B B B B B B B B B B B B V B B B B B B B B B B 
B V V B B B B B B B B B B B B B B B B B B B V V V V V V B V B B B B B B B B B B B B B B B B B B B B B B B B B B B B V B B B B B B B B B B B B B B B B B B B B B B B B B B B B B B V B B B B B B B B B B 
B B V V V B B B B B B B B B B B B B B B V V V B B B B V V V B B B B B B B B B B B B B B B B B B B B B B B B B B B B V B B B B B B B B B B B B B B B B B B B B B B B B B B B B B V V B B B B B B B B B B 
B B B B V V V B B B B B B B B B B V V V V B B B B B B B V B B B B B B B B B B B B B B B B B B B B B B B B B B B B B B V B B B B B B B B B B B B B B B B B B B B B B B B B B B B V B B B B B B B B B B B 
B B B B B B V V V V V V V V V V V V B B B B B B B B B B V V B B B B B B B B B B B B B B B B B B B B B B B B B B B B V V B B B B B B B B B B B B B B B B B B B B B B B B B B B V V B B B B B B B B B B B 
B B B B B B B B B B B B B B B B B B B B B B B B B B B B B V B B B B B B B B B B B B B B B B B B B B B B B B B B B B V B B B B B B B B B B B B B B B B B B B B B B B B B B B B V V B B B B B B B B B B B 
B B B B B B B B B B B B B B B B B B B B B B B B B B B B B V B B B B B B B B B B B B B B B B B B B B B B B B B B B B V B B B B B B B B B B B B B B B B B B B B B B B B B B B B V V B B B B B B B B B B B 
B B B B B B B B B B B B B B B B B B B B B B B B B B B B B V V B B B B B B B B B B B B B B B B B B B B B B B B B B V V B B B B B B B B B B B B B B B B B B B B B B B B B B B B V V B B B B B B B B B B B 
B B B B B B B B B B B B B B B B B B B B B B B B B B B B B B V V B B B B B B B B B B B B B B B B B B B B B B B B B V B B B B B B B B B B B B B B B B B B B B B B B B B B B B B V V B B B B B B B B B B B 
B B B B B B B B B B B B B B B B B B B B B B B B B B B B B B B V V B B B B B B B B B B B B B B B B B B B B B B B B V B B B B B B B B B B B B B B B B B B B B B B B B B B B B B V V B B B B B B B B B B B 
B B B B B B B B B B B B B B B B B B B B B B B B B B B B B B B B V V B B B B B B B B B B B B B B B B B B B B B B B V B B B B B B B B B B B B B B B B B B B B B B B B B B B B B V V B B B B B B B B B B B 
B B B B B B B B B B B B B B B B B B B B B B B B B B B B B B B B B V B B B B B B B B B B B B B B B B B B B B B B B V B B B B B B B B B B B B B B B B B B B B B B B B B B B B B V B B B B B B B B B B B B 
B B B B B B B B B B B B B B B B B B B B B B B B B B B B B B B B B V V B V V V V V V V V V V V V B B B B B B B B B V V B B B B B B B B B B B B B B B B B B B B B B B B B B B V V B B B B B B B B B B B B 
B B B B B B B B B B B B B B B B B B B B B B B B B B B B B B B B B V V V V B B B B B B B B B B V V V B B B B B B B B V B B B B B B B B B B B B B B B B B B B B B B B B B B V V B B B B B B B B B B B B B 
B B B B B B B B B B B B B B B B B B B B B B B B B B B B B B V V V V V V B B B B B B B B B B B B B V V V V B B B B B V B B B B B B B B B B B B B B B B B B B B B B B B B B V B B B B B B B B B B B B B B 
B B B B B B B B B B B B B B B B B B B B B B B B B B B B B V V B B B B V V B B B B B B B B B B B B B B B V V B B B B V B B B B B B B B B B B B B B B B B B B B B B B B B V V B B B B B B B B B B B B B B 
B B B B B B B B B B B B B B B B B B B B B B V V V V V V V V B B B B B B V V B B B B B B B B B B B B B B B V V V B B V V B B B B B B B B B B B B B B B B B B B B B B B B V V B B B B B B B B B B B B B B 
V V V B B B B B B B B V V V V V V V V V V V V V B B B B V B B B B B B B B V V B B B B B B B B B B B B B B B B V V B B V B B B B B B B B B B B B B B B B B B B B B B B B B V B B B B B B B B B B B B B V 
B B V V V V V V V V V V B B B B B B B B B B B B B B B V V B B B B B B B B B V B B B B B B B B B B B B B B B B B V V V V B B B B B B B B B B B B B B B B B B B B B B B B B V B B B B B B B B B B B B B V 
B B B B B B B B B B B B B B B B B B B B B B B B B B V V B B B B B B B B B B V V B B B B B B B B B B B B B B B B B B V V B B B B B B B B B B B B B B B B B B B B B B B B B V V B B B B B B B B B B B V V 
B B B B B B B B B B B B B B B B B B B B B B B B B B V B B B B B B B B B B B B V B B B B B B B B B B B B B B B B B B B V V B B B B B B B B B B B B B B B B B B B B B B B B B V B B B B B B B B B B V V B 
B B B B B B B B B B B B B B B B B B B B B B B B B V V B B B B B B B B B B B B V B B B B B B B B B B B B B B B B B B B B V V V B B B B B B B B B B B B B B B B B B B B B B B V V B B B B B B B B B V B B 
B B B B B B B B B B B B B B B B B B B B B B B B B V B B B B B B B B B B B B B V V B B B B B B B B B B B B B B B B B B B B B V V B B B B B B B B B B B B B B B B B B B B B B B V V B B B B B B B V V B B 
B B B B B B B B B B B B B B B B B B B B B B B B B V B B B B B B B B B B B B B B V B B B B B B B B B B B B B B B B B B B B B B V V B B B B B B B B B B B B B B B B B B B B B B B V B B B B B B V V B B B 
B B B B B B B B B B B B B B B B B B B B B B B B B V B B B B B B B B B B B B B B V V B B B B B B B B B B B B B B B B B B B B B B V V V B B B B B B B B B B B B B B B B B B B B B V B B B B B B V B B B B 
B B B B B B B B B B B B B B B B B B B B B B B B B V B B B B B B B B B B B B B B B V V B B B B B B B B B B B B B B B B B B B B B B B V V B B B B B B B B B B B B B B B B B B B B V V B B B B V V B B B B 
B B B B B B B B B B B B B B B B B B B B B B B B B V B B B B B B B B B B B B B B B B V B B B B B B B B B B B B B B V V V V V V B B B V V B B B B B B B B B B B B B B B B B B B B B V B B B B V B B B B B 
B B B B B B B B B B B B B B B B B B B B B B B B B V B B B B B B B B B B B B B B B B V V B B B V V V V V V V V V V V V V V V V V V V V V V B B B B B B B B B B B B B B B B B B B B V B B B V V B B B B B 
B B B B B B B B B B B B B B B B B B B B B B B B B V B B B B B B B B B B B B B B B B B V V B V V B B B B B B B B B B B B B B B B B B B B V V B B B B B B B B B B B B B B B B B B B V V B V V B B B B B B 
B B B B B B B B B B B B B B B B B B B B B B B B B V B B B B B B B B B B B B B B B B B B V V V B B B B B B B B B B B B B B B B B B B B B B V V B B B B B B B B B B B B B B B B B B B V V V B B B B B B B 
B B B B B B B B B B B B B B B B B B B B B B B B B V B B B B B B B B B B B B B B B B V V V V B B B B B B B B B B B B B B B B B B B B B B B B V V B B B B B B B B B B B B B B B B B B V V B B B B B B B B 
B B B B B B B B B B B B B B B B B B B B B B B B B V B B B B B B B B B B B B B V V V V B B V V B B B B B B B B B B B B B B B B B B B B B B B B V V B B B B B B B B B B B B B B B B B V V B B B B B B B B 
B B B B B B B B B B B B B B B B B B B B B B B B B V B B B B B B B B B B B V V V B B B B B B V V B B B B B B B B B B B B B B B B B B B B B B B B V V B B B B B B B B B B B B B B B B B V B B B B B B B B 
B B B B B B B B B B B B B B B B B B B B B B B B V B B B B B B B B B B B B V B B B B B B B B B V V V B B B B B B B B B B B B B B B B B B B B B B B V B B B B B B B B B B B B B B B B B V B B B B B B B B 
V B B B B B B B B B B B B B B B B B B B B B B B V B B B B B B B B B B B B V B B B B B B B B B V V V V B B B B B B B B B B B B B B B B B B B B B B V V B B B B B B B B B B B B B B B V V B B B B B B B B 
V V B B B B B B B B B B B B B B B B B B B B B B V B B B B B B B B B B B B V B B B B B B B B B V B B V V V B B B B B B B B B B B B B B B B B B B B B V V B B B B B B B B B B B B B B V B B B B B B B B B 
B V B B B B B B B B B B B B B B B B B B B B B B V B B B B B B B B B B B B V B B B B B B B B V V B B B B V V B B B B B B B B B B B B B B B B B B B B B V V B B B B B B B B B B B B V V B B B B B B B B B 
B V V B B B B B B B B B B B B B B B B B B B B B V B B B B B B B B B B B B V B B B B B B B V V B B B B B B V B B B B B B B B B B B B B B B B B B B B B B V B B B B B B B B B B B B V B B B B B B B B B B 
B B V V B B B B B B B B B B B B B B B B B B B B V B B B B B B B B B B B B V B B B B B B B V B B B B B B B V B B B B B B B B B B B B B B B B B B B B B B B V B B B B B B B B B B B V B B B B B B B B B B 
B B B V V V V V B B B B B B B B B B B B B B B B V V B B B B B B B B B B B V V B B B B B V V B B B B B B B V V B B B B B B B B B B B B B B B B B B B B B B V V V B B B B B B B B V V V B B B B B B B B B 
B B B B B B B V B B B B B B B B B B B B B B B B B V V B B B B B B B B B B B V B B B B V V B B B B B B B B B V B B B B B B B B B B B B B B B B B B B B B B B B V V B B B B B B B V B V V B B B B B B B B 
B B B B B B B V B B B B B B B B B B B B B B B B B B V B B B B B B B B B B B V B B V V V B B B B B B B B B B V B B B B B B B B B B B B B B B B B B B B B B B B B V V V B B B B V V B B V B B B B B B B B 
B B B B B B B V B B B B B B B B B B B B B B B B B B V V B B B B B B B B B B V V V V B B B B B B B B B B B B V B B B B B B B B B B B B B B B B B B B B B B B B B B B V V V B V V B B B V B B B B B B B B 
B B B B B B B V B B B B B B B B B B B B B B B B B B B V B B B B B B B B B V V V B B B B B B B B B B B B B B V B B B B B B B B B B B B B B B B B B B B B B B B B B B B V V V V B B B B V V B B B B B B B 
B B B B B B B V B B B B B B B B B B B B B B B B B B B V V V V B B B B B B V V V B B B B B B B B B B B B B B V V B B B B B B B B B B B B B B B B B B B B B B B B B V V V B B B B B B B B V B B B B B B B 
B B B B B B B V B B B B B B B B B B B B B V V V V V V V B B V V V B B B B V B B B B B B B B B B B B B B B B B V B B B B B B B B B B B B B B B B B B B B B B B V V V B B B B B B B B B B V V B B B B B B 
B B B B B B B V V B B B B B B B B B B B B V B B B V V B B B B B V V V B B V B B B B B B B B B B B B B B B B B V V B B B B B B B B B B B B B B B B B B B B B V V B B B B B B B B B B B B B V V V B B B B 
B B B B B B B B V B B B B B B B B B B B B V B B B B B B B B B B B B V V V V B B B B B B B B B B B B B B B B B B V B B B B B B B B B B B B B B B B B B B B V V B B B B B B B B B B B B B B B B V V V V B 
B B B B B B B B V V B B B B B B B B B B B V B B B B B B B B B B B B B B B V B B B B B B B B B B B B B B B B B B V V B B B B B B B B B B B B B B B B B B B V B B B B B B B B B B B B B B B B B B B B V B 
B B B B B B B B B V B B B B B B B B B B B V B B B B B B B B B B B B B B B V B B B B B B B B B B B B B B B B B B B V B B B B B B B B B B B B B B B B B B B V B B B B B B B B B B B B B B B B B B B B B B 
B B B B B B B B B V V B B B B B B B B B B V B B B B B B B B B B B B B B B V V B B B B B B B B B B B B B B B B B B V V B B B B B B B B B B B B B B B B B B V B B B B B B B B B B B B B B B B B B B B B B 
B B B B B B B B B B V B B B B B B B B B V V B B B B B B B B B B B B B B B B V V B B B B B B B B B B B B B B B B B B V B B B B B B B B B B B B B B B B B B V B B B B B B B B B B B B B B B B B B B B B B 
B B B B B B B B B B V B B B B B B B B B V B B B B B B B B B B B B B B B B B B V B B B B B B B B B B B B B B B B B B V V B B B B B B B B B B B B B B B B B V B B B B B B B B B B B B B B B B B B B B B B 
B B B B B B B B B B V V B B B B B B B B V B B B B B B B B B B B B B B B B B B V B B B B B B B B B B B B B B B B B B B V V B B B B B B B B B B B B B B B B V B B B B B B B B B B B B B B B B B B B B B B 
B B B B B B B B B B B V B B B B B B B B V B B B B B B B B B B B B B B B B B B V B B B B B B B B B B B B B B B B B B B B V V B B B B B B B B B B B B B B B V B B B B B B B B B B B B B B B B B B B B B B 
B B B B B B B B B B B V V B B B B B B V V B B B B B B B B B B B B B B B B B B V V B B B B B B B B B B B B B B B B B B B B V B B B B B B B B B B B B B B B V B B B B B B B B B B B B B B B B B B B B B B 
B B B B B B B B B B B B V B B B B B B V B B B B B B B B B B B B B B B B B B B B V B B B B B B B B B B B B B B B B B B B B V V B B B B B B B B B B B B B B V B B B B B B B B B B B B B B B B B B B B B B 
B B B B B B B B B B B B V B B B B B B V B B B B B B B B B B B B B B B B B B B B V B B B B B B B B B B B B B B B B B B B B B V B B B B B B B B B B B B B V V B B B B B B B B B B B B B B B B B B B B B B 
B B B B B B B B B B B B V V B B B B B V B B B B B B B B B B B B B B B B B B B B V V B B B B B B B B B B B B B B B B B B B B V V B B B B B B B B B B B B V B B B B B B B B B B B B B B B B B B B B B B B 
B B B B B B B B B B B B B V B B B B B V B B B B B B B B B B B B B B B B B B B B B V B B B B B B B B B B B B B B B B B B B B B V V B B B B B B B B B B B V B B B B B B B B B B B B B B B B B B B B B B B 
B B B B B B B B B B B B B V B B B B B V B B B B B B B B B B B B B B B B B B B B B V B B B B B B B B B B B B B B B B B B B B B B V B B B B B B B B B B V V B B B B B B B B B B B B B B B B B B B B B B B 
B B B B B B B B B B B B B V V B B B V V B B B B B B B B B B B B B B B B B B B B B V B B B B B B B B B B B B B B B B B B B B B B V V V B B B B B B B B V B B B B B B B B B B B B B B B B B B B B B B B B 
B B B B B B B B B B B B B B V B B B V B B B B B B B B B B B B B B B B B B B B B B V V B B B B B B B B B B B B B B B B B B B B B B B V V V B B B B B B V V B B B B B B B B B B B B B B B B B B B B B B B 
B B B B B B B B B B B B B B V B B V V B B B B B B B B B V V B B B B B B B B B B B B V B B B B B B B B B B B B B B B B B B B B B B B B B V B B B B B B B V B B B B B B B B B B B B B B B B B B B B B B B 
B B B B B B B B B B B B B B V V B V B B B B B B B V V V V V V V V V V V V V B B B B V B B B B B B B B B B B B B B B B B B B B B B B B B V V B B B B B B V B B B B B B B B B B B B B B B B B B B B B B B 
B B B B B B B B B B B B B B B V B V V V V V V V V V B B B B B B B V V V V V V V V V V V B B V V V V V V V B B B B B B B B B B B B B B B B V B B B B B B V B B B B B B B B B B B B B B B B B B B B B B B 
B B B B B B B B B B B B B B B V V B B B B B B B B B B B B B B B B B B B B B B B B B V V V V B B B B B B V V V B B B B B B B B B B B B B B V V B B B B B V B B B B B B B B B B B B B B B B B B B B B B B 
B B B B B B B B B B B B B B B B V B B B B B B B B B B B B B B B B B B B B B B B B B B V V B B B B B B B B B V V V V V V V V B B B B B B B B V V B B B V V B B B B B B B B B B B B B B B B B B B B B B B 
B B B B B B B B B B B B B B B B V V B B B B B B B B B B B B B B B B B B B B B B B B B B V B B B B B B B B B B B B B B B B V V V V V V V V V V V V B B V B B B B B B B B B B B B B B B B B B B B B B B B 
B B B B B B B B B B B B B B B B B V V B B B B B B B B B B B B B B B B B B B B B B B B B V B B B B B B B B B B B B B B B B B B B B B B B B B B V V V V V V B B B B B B B B B B B B B B B B B B B B B B B 
B B B B B B B B B B B B B B B B B B V V B B B B B B B B B B B B B B B B B B B B B B B B V V B B B B B B B B B B B B B B B B B B B B B B B B B V V B V V V V V V V B B B B B B B B B B B B B B B B B B B 
B B B B B B B B B B B B B B B B B B B V V B B B B B B B B B B B B B B B B B B B B B B B B V B B B B B B B B B B B B B B B B B B B B B B B B B B V V V B B B B B V V V V B B B B B B B B B B B B B B B B 
B B B B B B B B B B B B B B B B B B B B V B B B B B B B B B B B B B B B B B B B B B B B B V V B B B B B B B B B B B B B B B B B B B B B B B B B V V B B B B B B B B B V V V B B B B B B B B B B B B B B 
B B B B B B B B B B B B B B B B B B B B V B B B B B B B B B B B B B B B B B B B B B B B B B V B B B B B B B B B B B B B B B B B B B B B B B V V V V B B B B B B B B B B B V V V V V B B B B B B B B B B 
B B B B B B B B B B B B B B B B B B B B V B B B B B B B B B B B B B B B B B B B B B B B B B V V B B B B B B B B B B B B B B B B B B B B B V V B B V B B B B B B B B B B B B B B B V V V B B B B B B B B 
B B B B B B B B B B B B B B B B B B B B V V B B B B B B B B B B B B B B B B B B B B B B B B B V V B B B B B B B B B B B B B B B B B B B V V B B B V V B B B B B B B B B B B B B B B B V V B B B B B B B 
B B B B B B B B B B B B B B B B B B B B B V B B B B B B B B B B B B B B B B B B B B B B B B B B V V B B B B B B B B B B B B B B B B V V B B B B B B V B B B B B B B B B B B B B B B B B V V V B B B B B 
B B B B B B B B B B B B B B B B B B B B B V B B B B B B B B B B B B B B B B B B B B B B B B B B B V B B B B B B B B B B B B B B B V V B B B B B B B V V B B B B B B B B B B B B B B B B B B V V B B B B 
B B B B B B B B B B B B B B B B B B B B B V B B B B B B B B B B B B B B B B B B B B B B B B B B B V B B B B B B B B B B B B B B V B B B B B B B B B B V B B B B B B B B B B B B B B B B B B B V V B B B 
B B B B B B B B B B B B B B B B B B B B B V B B B B B B B B B B B B B B B B B B B B B B B B B B B V V B B B B B B B B B B B B B V B B B B B B B B B B V V B B B B B B B B B B B B B B B B B B B V B B B 
B B B B B B B B B B B B B B B B B B B B B V B B B B B B B B B B B B B B B B B B B B B B B B B B B B V B B B B B B B B B B B B V V B B B B B B B B B B B V B B B B B B B B B B B B B B B B B B B V V B B 
B B B B B B B B B B B B B B B B B B B B B V B B B B B B B B B B B B B B B B B B B B B B B B B B B B V B B B B B B B B B B B B V B B B B B B B B B B B B V V B B B B B B B B B B B B B B B B B B B V V B 
B B B B B B B B B B B B B B B B B B B B B V V B B B B B B B B B B B B B B B B B B B B B B B B B B B V B B B B B B B B B B B V V B B B B B B B B B B B B B V B B B B B B B B B B B B B B B B B B B B V V 
B B B B B B B B B B B B B B B B B B B B B B V B B B B B B B B B B B B B B B B B B B B B B B B B B B V B B B B B B B B B B B V B B B B B B B B B B B B B B V B B B B B B B B B B B B B B B B B B B B B V 
B B B B B B B B B B B B B B B B B B B B B B V B B B B B B B B B B B B B B B B B B B B B B B B B B B V B B B B B B B B B B V V B B B B B B B B B B B B B B V B B B B B B B B B B B B B B B B B B B B B B 
B B B B B B B B B B B B B B B B B B B B B B V V B B B B B B B B B B B B B B B B B B B B B B B B B B V B B B B B B B B B V V B B B B B B B B B B B B B B B V B B B B B B B B B B B B B B B B B B B B B B 
B B B B B B B B B B B B B B B B B B B B B B B V B B B B B B B B B B B B B B B B B B B B B B B B B B V B B B B B B B B V V B B B B B B B B B B B B B B B B V B B B B B B B B B B B B B B B B B B B B B B 
B B B B B B B B B B B B B B B B B B B B B B B V V B B B B B B B B B B B B B B B B B B B B B B B B B V V B B B B B B V V B B B B B B B B B B B B B B B B B V V B B B B B B B B B B B B B B B B B B B B B 
B B B B B B B B B B B B B B B B B B B B B B B B V B B B B B B B B B B B B B B B B B B B B B B B B B B V B B B V V V V B B B B B B B B B B B B B B B B B B B V B B B B B B B B B B B B B B B B B B B B B 
B B B B B B B B B B B B B B B B B B B B B B B B V B B B B B B B B B B B B B B B B B B B B B B B B B B V B V V V B B B B B B B B B B B B B B B B B B B B B B V V B B B B B B B B B B B B B B B B B B B B 
B B B B B B B B B B B B B B B B B B B B B B B B V V B B B B B B B B B B B B B B B B B B B B B B B B B V V V B B B B B B B B B B B B B B B B B B B B B B B B B B B B B B B B B B B B B B B B B B B B B B 
B B B B B B B B B B B B B B B B B B B B B B B B B B B B B B B B B B B B B B B B B B B B B B B B B B B B B B B B B B B B B B B B B B B B B B B B B B B B B B B B B B B B B B B B B B B B B B B B B B B B 
B B B B B B B B B B B B B B B B B B B B B B B B B B B B B B B B B B B B B B B B B B B B B B B B B B B B B B B B B B B B B B B B B B B B B B B B B B B B B B B B B B B B B B B B B B B B B B B B B B B B 
